DATE,TOTAL_CASES,NEW_CASES,TOTAL_CONFIRMED,NEW_CONFIRMED,TOTAL_PROBABLE,NEW_PROBABLE,POS_TESTS,NEG_TESTS,TOTAL_TESTS,NEW_TESTS,NEW_DEATHS,TOTAL_DEATHS,NEW_ACTIVE,TOTAL_ACTIVE,NEW_INACTIVE_RECOVERED,TOTAL_INACTIVE_RECOVERED,NEW_HOSP,TOTAL_HOSP,TOTAL_DEATHS_BY_DOD,NEW_DEATHS_BY_DOD
5/27/21,862401,405,710379,262,152022,143,818866,7142537,7961403,10678,13,12441,-236,4898,628,845062,3,21918,12433,1
5/26/21,861996,516,710117,366,151879,150,818539,7132186,7950725,12262,22,12428,-102,5134,596,844434,13,21915,12432,6
5/25/21,861480,437,709751,282,151729,155,818109,7120354,7938463,9274,6,12406,-184,5236,615,843838,9,21902,12426,8
5/24/21,861043,464,709469,317,151574,147,817798,7111391,7929189,7875,7,12400,-319,5420,776,843223,13,21893,12418,2
5/23/21,860579,258,709152,190,151427,68,817424,7103890,7921314,5391,6,12393,-225,5739,477,842447,9,21880,12416,7
5/22/21,860321,314,708962,227,151359,87,817186,7098737,7915923,7490,3,12387,-157,5964,468,841970,14,21871,12409,3
5/21/21,860007,525,708735,347,151272,178,816882,7091551,7908433,10234,4,12384,-156,6121,677,841502,11,21857,12406,8
5/20/21,859482,554,708388,391,151094,163,816486,7081713,7898199,24057,16,12380,-216,6277,754,840825,18,21846,12398,11
5/19/21,858928,638,707997,462,150931,176,816018,7058124,7874142,13949,11,12364,-182,6493,809,840071,25,21828,12387,7
5/18/21,858290,573,707535,390,150755,183,815471,7044722,7860193,10641,14,12353,-273,6675,832,839262,21,21803,12380,6
5/17/21,857717,660,707145,390,150572,270,815036,7034516,7849552,9139,12,12339,-310,6948,958,838430,20,21782,12374,10
5/16/21,857057,276,706755,201,150302,75,814571,7025842,7840413,5293,4,12327,-258,7258,530,837472,15,21762,12364,10
5/15/21,856781,399,706554,290,150227,109,814319,7020801,7835120,8622,1,12323,-221,7516,619,836942,12,21747,12354,7
5/14/21,856382,808,706264,580,150118,228,813929,7012569,7826498,12084,10,12322,59,7737,739,836323,29,21735,12347,12
5/13/21,855574,709,705684,473,149890,236,813259,7001155,7814414,12390,7,12312,-177,7678,879,835584,17,21706,12335,5
5/12/21,854865,897,705211,661,149654,236,812707,6989317,7802024,17235,9,12305,-41,7855,929,834705,31,21689,12330,10
5/11/21,853968,846,704550,620,149418,226,811887,6972902,7784789,11474,4,12296,-150,7896,992,833776,28,21658,12320,6
5/10/21,853122,629,703930,381,149192,248,811247,6962068,7773315,7515,16,12292,-572,8046,1185,832784,30,21630,12314,10
5/9/21,852493,376,703549,283,148944,93,810812,6954988,7765800,6858,19,12276,-333,8618,690,831599,20,21600,12304,8
5/8/21,852117,559,703266,396,148851,163,810484,6948458,7758942,10282,0,12257,-85,8951,644,830909,13,21580,12296,9
5/7/21,851558,1034,702870,734,148688,300,809975,6938685,7748660,14997,2,12257,69,9036,963,830265,25,21567,12287,8
5/6/21,850524,789,702136,542,148388,247,809125,6924538,7733663,11572,11,12255,-286,8967,1064,829302,24,21542,12279,12
5/5/21,849735,1208,701594,759,148141,449,808492,6913599,7722091,17612,16,12244,226,9253,966,828238,37,21518,12267,12
5/4/21,848527,853,700835,598,147692,255,807619,6896860,7704479,12161,11,12228,-304,9027,1146,827272,30,21481,12255,9
5/3/21,847674,655,700237,449,147437,206,806925,6885393,7692318,8383,13,12217,-635,9331,1277,826126,30,21451,12246,6
5/2/21,847019,499,699788,373,147231,126,806403,6877532,7683935,7358,1,12204,-222,9966,720,824849,22,21421,12240,11
5/1/21,846520,608,699415,446,147105,162,805966,6870611,7676577,10355,-1,12203,-131,10188,740,824129,23,21399,12229,7
4/30/21,845912,1073,698969,771,146943,302,805475,6860747,7666222,14923,7,12204,12,10319,1054,823389,29,21376,12222,10
4/29/21,844839,1029,698198,681,146641,348,804607,6846692,7651299,14642,9,12197,-119,10307,1139,822335,29,21347,12212,10
4/28/21,843810,1194,697517,859,146293,335,803830,6832827,7636657,20508,17,12188,-94,10426,1271,821196,45,21318,12202,9
4/27/21,842616,1159,696658,710,145958,449,802832,6813317,7616149,13779,8,12171,-80,10520,1231,819925,46,21273,12193,12
4/26/21,841457,1091,695948,713,145509,378,802034,6800336,7602370,9822,11,12163,-377,10600,1457,818694,28,21227,12181,11
4/25/21,840366,552,695235,425,145131,127,801251,6791297,7592548,8248,6,12152,-269,10977,815,817237,26,21199,12170,7
4/24/21,839814,752,694810,564,145004,188,800736,6783564,7584300,13044,0,12146,-174,11246,926,816422,30,21173,12163,7
4/23/21,839062,953,694246,690,144816,263,800093,6771163,7571256,14907,4,12146,-217,11420,1166,815496,24,21143,12156,5
4/22/21,838109,1848,693556,1041,144553,807,799252,6757097,7556349,22084,12,12142,551,11637,1285,814330,33,21119,12151,12
4/21/21,836261,1382,692515,943,143746,439,798061,6736204,7534265,17937,19,12130,118,11086,1245,813045,24,21086,12139,15
4/20/21,834879,1096,691572,900,143307,196,797006,6719322,7516328,13973,15,12111,-260,10968,1341,811800,46,21062,12124,8
4/19/21,833783,841,690672,546,143111,295,796031,6706324,7502355,9282,15,12096,-691,11228,1517,810459,37,21016,12116,11
4/18/21,832942,560,690126,479,142816,81,795417,6697656,7493073,8184,17,12081,-162,11919,705,808942,17,20979,12105,11
4/17/21,832382,705,689647,574,142735,131,794841,6690048,7484889,11805,1,12064,-77,12081,781,808237,17,20962,12094,10
4/16/21,831677,4214,689073,3993,142604,221,794172,6678912,7473084,35540,14,12063,3240,12158,960,807456,37,20945,12084,6
4/15/21,827463,1374,685080,998,142383,376,789477,6648067,7437544,18271,8,12049,158,8918,1208,806496,35,20908,12078,12
4/14/21,826089,1803,684082,1337,142007,466,788381,6630892,7419273,24930,9,12041,651,8760,1143,805288,36,20873,12066,11
4/13/21,824286,1138,682745,708,141541,430,786862,6607481,7394343,10967,10,12032,-98,8109,1226,804145,33,20837,12055,11
4/12/21,823148,1231,682037,881,141111,350,786107,6597269,7383376,9376,7,12022,-155,8207,1379,802919,31,20804,12044,15
4/11/21,821917,653,681156,461,140761,192,785111,6588889,7374000,7668,3,12015,-187,8362,837,801540,21,20773,12029,5
4/10/21,821264,872,680695,605,140569,267,784590,6581742,7366332,12240,8,12012,122,8549,742,800703,24,20752,12024,10
4/9/21,820392,1339,680090,1044,140302,295,783853,6570239,7354092,16476,3,12004,216,8427,1120,799961,37,20728,12014,13
4/8/21,819053,1148,679046,781,140007,367,782710,6554906,7337616,15052,4,12001,-50,8211,1194,798841,22,20691,12001,5
4/7/21,817905,1582,678265,1186,139640,396,781825,6540739,7322564,21230,21,11997,327,8261,1234,797647,34,20669,11996,8
4/6/21,816323,1335,677079,883,139244,452,780523,6520811,7301334,14562,9,11976,66,7934,1260,796413,26,20635,11988,5
4/5/21,814988,892,676196,516,138792,376,779516,6507256,7286772,6216,38,11967,-618,7868,1472,795153,43,20609,11983,10
4/4/21,814096,551,675680,414,138416,137,778955,6501601,7280556,9601,7,11929,-263,8486,807,793681,10,20566,11973,16
4/3/21,813545,895,675266,636,138279,259,778464,6492491,7270955,10429,0,11922,8,8749,887,792874,17,20556,11957,14
4/2/21,812650,1066,674630,811,138020,255,777742,6482784,7260526,14203,1,11922,-67,8741,1132,791987,18,20539,11943,11
4/1/21,811584,1249,673819,898,137765,351,776788,6469535,7246323,14414,6,11921,-194,8808,1437,790855,18,20521,11932,7
3/31/21,810335,1867,672921,1195,137414,672,775794,6456115,7231909,22836,11,11915,591,9002,1265,789418,29,20503,11925,11
3/30/21,808468,1193,671726,879,136742,314,774410,6434663,7209073,14239,10,11904,-100,8411,1283,788153,34,20474,11914,9
3/29/21,807275,1193,670847,616,136428,577,773390,6421444,7194834,8854,29,11894,-286,8511,1450,786870,25,20440,11905,6
3/28/21,806082,815,670231,566,135851,249,772650,6413330,7185980,10826,13,11865,-45,8797,847,785420,24,20415,11899,8
3/27/21,805267,814,669665,744,135602,70,772001,6403153,7175154,13029,11,11852,3,8842,800,784573,22,20391,11891,9
3/26/21,804453,994,668921,797,135532,197,771095,6391030,7162125,11720,25,11841,-245,8839,1214,783773,14,20369,11882,15
3/25/21,803459,1145,668124,870,135335,275,770249,6380156,7150405,16324,20,11816,-108,9084,1233,782559,35,20355,11867,6
3/24/21,802314,1608,667254,1278,135060,330,769280,6364801,7134081,21266,4,11796,378,9192,1226,781326,28,20320,11861,6
3/23/21,800706,1171,665976,722,134730,449,767922,6344893,7112815,14486,45,11792,-134,8814,1260,780100,33,20292,11855,12
3/22/21,799535,1266,665254,808,134281,458,767111,6331218,7098329,9714,34,11747,-55,8948,1287,778840,35,20259,11843,13
3/21/21,798269,757,664446,562,133823,195,766185,6322430,7088615,8880,8,11713,-9,9003,758,777553,7,20224,11830,13
3/20/21,797512,754,663884,517,133628,237,765564,6314171,7079735,9693,4,11705,-25,9012,775,776795,17,20217,11817,7
3/19/21,796758,1941,663367,1287,133391,654,765010,6305032,7070042,22134,28,11701,757,9037,1156,776020,32,20200,11810,11
3/18/21,794817,1415,662080,967,132737,448,763597,6284311,7047908,18711,23,11673,278,8280,1114,774864,42,20168,11799,14
3/17/21,793402,1071,661113,825,132289,246,762478,6266719,7029197,15438,8,11650,-82,8002,1145,773750,24,20126,11785,19
3/16/21,792331,1937,660288,1246,132043,691,761578,6252181,7013759,19032,12,11642,727,8084,1198,772605,50,20102,11766,9
3/15/21,790394,903,659042,498,131352,405,760136,6234591,6994727,5276,11,11630,-246,7357,1138,771407,24,20052,11757,8
3/14/21,789491,662,658544,460,130947,202,759590,6229861,6989451,8039,0,11619,-91,7603,753,770269,17,20028,11749,16
3/13/21,788829,1486,658084,802,130745,684,759035,6222377,6981412,16649,-12,11619,605,7694,893,769516,22,20011,11733,12
3/12/21,787343,1111,657282,838,130061,273,758099,6206664,6964763,13854,16,11631,-21,7089,1116,768623,13,19989,11721,19
3/11/21,786232,1366,656444,923,129788,443,757096,6193813,6950909,19243,17,11615,169,7110,1180,767507,15,19976,11702,12
3/10/21,784866,1598,655521,1132,129345,466,756072,6175594,6931666,23672,18,11598,298,6941,1282,766327,29,19961,11690,25
3/9/21,783268,1350,654389,806,128879,544,754800,6153194,6907994,17105,32,11580,-37,6643,1355,765045,24,19932,11665,21
3/8/21,781918,1087,653583,676,128335,411,753851,6137038,6890889,7645,9,11548,-556,6680,1634,763690,15,19908,11644,26
3/7/21,780831,752,652907,472,127924,280,753078,6130166,6883244,7138,4,11539,-201,7236,949,762056,9,19893,11618,23
3/6/21,780079,1234,652435,841,127644,393,752502,6123604,6876106,18287,9,11535,169,7437,1056,761107,20,19884,11595,20
3/5/21,778845,1227,651594,781,127251,446,751475,6106344,6857819,14116,33,11526,-69,7268,1263,760051,14,19864,11575,19
3/4/21,777618,1609,650813,1066,126805,543,750561,6093142,6843703,25298,42,11493,569,7337,998,758788,27,19850,11556,18
3/3/21,776009,1307,649747,882,126262,425,749269,6069136,6818405,18078,23,11451,14,6768,1270,757790,22,19823,11538,23
3/2/21,774702,1551,648865,983,125837,568,748237,6052090,6800327,15999,15,11428,526,6754,1010,756520,32,19801,11515,11
3/1/21,773151,568,647882,359,125269,209,747065,6037263,6784328,3824,10,11413,-434,6228,992,755510,16,19769,11504,14
2/28/21,772583,841,647523,582,125060,259,746668,6033836,6780504,10209,18,11403,-70,6662,893,754518,11,19753,11490,13
2/27/21,771742,1438,646941,855,124801,583,745987,6024308,6770295,18086,16,11385,377,6732,1045,753625,23,19742,11477,16
2/26/21,770304,1130,646086,793,124218,337,744948,6007261,6752209,11959,56,11369,-562,6355,1636,752580,16,19719,11461,11
2/25/21,769174,1682,645293,1175,123881,507,744024,5996226,6740250,22425,55,11313,-96,6917,1723,750944,37,19703,11450,23
2/24/21,767492,1923,644118,1476,123374,447,742668,5975157,6717825,24675,68,11258,-41,7013,1896,749221,39,19666,11427,19
2/23/21,765569,1844,642642,1126,122927,718,740939,5952211,6693150,16865,45,11190,-376,7054,2175,747325,44,19627,11408,21
2/22/21,763725,1057,641516,601,122209,456,739699,5936586,6676285,6161,20,11145,-1276,7430,2313,745150,37,19583,11387,23
2/21/21,762668,872,640915,583,121753,289,738997,5931127,6670124,6860,18,11125,-271,8706,1125,742837,15,19546,11364,30
2/20/21,761796,1366,640332,836,121464,530,738295,5924969,6663264,12464,51,11107,-57,8977,1372,741712,31,19531,11334,20
2/19/21,760430,998,639496,643,120934,355,737381,5913419,6650800,6665,7,11056,-926,9034,1917,740340,37,19500,11314,29
2/18/21,759432,1486,638853,952,120579,534,736648,5907487,6644135,12978,72,11049,-648,9960,2062,738423,42,19463,11285,30
2/17/21,757946,932,637901,596,120045,336,735571,5895586,6631157,6595,31,10977,-1300,10608,2201,736361,16,19421,11255,38
2/16/21,757014,1232,637305,784,119709,448,734887,5889675,6624562,9889,17,10946,-1244,11908,2459,734160,30,19405,11217,31
2/15/21,755782,779,636521,453,119261,326,733999,5880674,6614673,6226,4,10929,-2027,13152,2802,731701,13,19375,11186,26
2/14/21,755003,1255,636068,899,118935,356,733472,5874975,6608447,13046,31,10925,-356,15179,1580,728899,23,19362,11160,31
2/13/21,753748,1678,635169,1121,118579,557,732423,5862978,6595401,19166,9,10894,14,15535,1655,727319,30,19339,11129,33
2/12/21,752070,1928,634048,1382,118022,546,731088,5845147,6576235,22320,81,10885,-396,15521,2243,725664,21,19309,11096,27
2/11/21,750142,2420,632666,1738,117476,682,729463,5824452,6553915,25276,81,10804,-282,15917,2621,723421,35,19288,11069,34
2/10/21,747722,2140,630928,1517,116794,623,727472,5801167,6528639,24636,100,10723,-579,16199,2619,720800,39,19253,11035,37
2/9/21,745582,2700,629411,1780,116171,920,725697,5778306,6504003,21680,65,10623,-588,16778,3223,718181,57,19214,10998,40
2/8/21,742882,1249,627631,785,115251,464,723560,5758763,6482323,6678,97,10558,-2328,17366,3480,714958,30,19157,10958,36
2/7/21,741633,1354,626846,940,114787,414,722649,5752996,6475645,12771,6,10461,-435,19694,1783,711478,27,19127,10922,26
2/6/21,740279,3664,625906,2594,114373,1070,721608,5741266,6462874,39408,58,10455,1595,20129,2011,709695,44,19100,10896,58
2/5/21,736615,2184,623312,1569,113303,615,718370,5705096,6423466,22738,203,10397,-773,18534,2754,707684,53,19056,10838,50
2/4/21,734431,2897,621743,2081,112688,816,716410,5684318,6400728,32436,169,10194,-545,19307,3273,704930,69,19003,10788,49
2/3/21,731534,3349,619662,2253,111872,1096,714057,5654235,6368292,27513,133,10025,24,19852,3192,701657,87,18934,10739,40
2/2/21,728185,1315,617409,837,110776,478,711488,5629291,6340779,6562,147,9892,-2881,19828,4049,698465,25,18847,10699,43
2/1/21,726870,1692,616572,1052,110298,640,710583,5623634,6334217,8144,103,9745,-1897,22709,3486,694416,51,18822,10656,51
1/31/21,725178,2176,615520,1382,109658,794,709433,5616640,6326073,17538,76,9642,-3,24606,2103,690930,48,18771,10605,48
1/30/21,723002,3524,614138,2946,108864,578,707705,5600830,6308535,38106,113,9566,806,24609,2605,688827,50,18723,10557,50
1/29/21,719478,1765,611192,1239,108286,526,704178,5566251,6270429,13889,44,9453,-1903,23803,3624,686222,36,18673,10507,55
1/28/21,717713,3962,609953,2019,107760,1943,702681,5553859,6256540,20461,101,9409,-358,25706,4219,682598,82,18637,10452,70
1/27/21,713751,2728,607934,2066,105817,662,700414,5535665,6236079,20353,154,9308,-1244,26064,3818,678379,59,18555,10382,62
1/26/21,711023,3140,605868,2322,105155,818,698127,5517599,6215726,22538,192,9154,-1931,27308,4879,674561,72,18496,10320,82
1/25/21,707883,1822,603546,1221,104337,601,695536,5497652,6193188,11639,111,8962,-3531,29239,5242,669682,52,18424,10238,76
1/24/21,706061,1599,602325,1308,103736,291,694160,5487389,6181549,13244,40,8851,-1657,32770,3216,664440,40,18372,10162,82
1/23/21,704462,4487,601017,3169,103445,1318,692638,5475667,6168305,38166,42,8811,1097,34427,3348,661224,88,18332,10080,73
1/22/21,699975,2634,597848,1965,102127,669,688590,5441549,6130139,21622,93,8769,-2531,33330,5072,657876,52,18244,10007,74
1/21/21,697341,4710,595883,3506,101458,1204,686310,5422207,6108517,31108,128,8676,-1950,35861,6532,652804,82,18192,9933,107
1/20/21,692631,3112,592377,2095,100254,1017,682364,5395045,6077409,19972,86,8548,-2781,37811,5807,646272,57,18110,9826,86
1/19/21,689519,4774,590282,2772,99237,2002,679918,5377519,6057437,22858,40,8462,-3159,40592,7893,640465,111,18053,9740,99
1/18/21,684745,1616,587510,1067,97235,549,676594,5357985,6034579,7862,39,8422,-7213,43751,8790,632572,41,17942,9641,80
1/17/21,683129,2569,586443,1875,96686,694,675504,5351213,6026717,15254,36,8383,-1884,50964,4417,623782,52,17901,9561,90
1/16/21,680560,6930,584568,5343,95992,1587,673438,5338025,6011463,46112,44,8347,1317,52848,5569,619365,122,17849,9471,89
1/15/21,673630,2759,579225,1813,94405,946,666925,5298426,5965351,14578,79,8303,-665,51531,3345,613796,57,17727,9382,90
1/14/21,670871,6158,577412,4798,93459,1360,664949,5285824,5950773,37427,84,8224,-277,52196,6351,610451,98,17670,9292,106
1/13/21,664713,4120,572614,2877,92099,1243,659393,5253953,5913346,20735,137,8140,-4020,52473,8003,604100,65,17572,9186,77
1/12/21,660593,4747,569737,3007,90856,1740,656386,5236225,5892611,20602,146,8003,-5992,56493,10593,596097,75,17507,9109,98
1/11/21,655846,3787,566730,2679,89116,1108,653135,5218874,5872009,14869,80,7857,-6330,62485,10037,585504,77,17432,9011,102
1/10/21,652059,5381,564051,3697,88008,1684,650204,5206936,5857140,29948,81,7777,1034,68815,4266,575467,84,17355,8909,107
1/9/21,646678,7220,560354,5751,86324,1469,645589,5181603,5827192,39409,86,7696,2005,67781,5129,571201,88,17271,8802,89
1/8/21,639458,6049,554603,4572,84855,1477,638885,5148898,5787783,33867,126,7610,4238,65776,1685,566072,96,17183,8713,118
1/7/21,633409,7341,550031,6301,83378,1040,632914,5121002,5753916,33688,111,7484,3155,61538,4075,564387,98,17087,8595,91
1/6/21,626068,7361,543730,5161,82338,2200,626548,5093680,5720228,28870,114,7373,442,58383,6805,560312,129,16989,8504,115
1/5/21,618707,8405,538569,5139,80138,3266,621022,5070336,5691358,25823,99,7259,-776,57941,9082,553507,129,16860,8389,115
1/4/21,610302,4048,533430,3000,76872,1048,615701,5049834,5665535,10891,143,7160,-4625,58717,8530,544425,67,16731,8274,107
1/3/21,606254,3513,530430,2374,75824,1139,612728,5041916,5654644,12404,55,7017,-260,63342,3718,535895,56,16664,8167,103
1/2/21,602741,7196,528056,5730,74685,1466,610286,5031954,5642240,30035,15,6962,3106,63602,4075,532177,98,16608,8064,86
1/1/21,595545,6675,522326,5223,73219,1452,603725,5008480,5612205,28067,48,6947,-403,60496,7030,528102,77,16510,7978,97
12/31/20,588870,9173,517103,7235,71767,1938,598119,4986019,5584138,35512,97,6899,1924,60899,7152,521072,74,16433,7881,99
12/30/20,579697,6697,509868,4529,69829,2168,590035,4958591,5548626,22248,100,6802,-716,58975,7313,513920,81,16359,7782,99
12/29/20,573000,8075,505339,4950,67661,3125,585094,4941284,5526378,23330,122,6702,60,59691,7893,506607,115,16278,7683,98
12/28/20,564925,3545,500389,2630,64536,915,579774,4923274,5503048,10180,76,6580,-6592,59631,10061,498714,79,16163,7585,89
12/27/20,561380,3373,497759,2291,63621,1082,576925,4915943,5492868,13185,69,6504,-449,66223,3753,488653,75,16084,7496,87
12/26/20,558007,4886,495468,3546,62539,1340,574149,4905534,5479683,21743,7,6435,848,66672,4031,484900,86,16009,7409,91
12/25/20,553121,6624,491922,5435,61199,1189,570269,4887671,5457940,33411,5,6428,-565,65824,7184,480869,54,15923,7318,80
12/24/20,546497,6644,486487,5028,60010,1616,564240,4860289,5424529,32446,51,6423,-523,66389,7116,473685,46,15869,7238,106
12/23/20,539853,6093,481459,3968,58394,2125,558515,4833568,5392083,26392,111,6372,-1335,66912,7317,466569,84,15823,7132,97
12/22/20,533760,6907,477491,4711,56269,2196,553941,4811750,5365691,29083,133,6261,-816,68247,7590,459252,125,15739,7035,109
12/21/20,526853,5821,472780,4377,54073,1444,548664,4787944,5336608,26611,65,6128,-3916,69063,9672,451662,83,15614,6926,104
12/20/20,521032,9996,468403,8343,52629,1653,543776,4766221,5309997,61064,54,6063,6430,72979,3512,441990,107,15531,6822,101
12/19/20,511036,7075,460060,6032,50976,1043,534210,4714723,5248933,41319,57,6009,3193,66549,3825,438478,70,15424,6721,93
12/18/20,503961,8266,454028,6980,49933,1286,526808,4680806,5207614,40586,115,5952,1875,63356,6276,434653,93,15354,6628,96
12/17/20,495695,10159,447048,8064,48647,2095,519366,4647662,5167028,44537,177,5837,3149,61481,6833,428377,115,15261,6532,92
12/16/20,485536,9312,438984,6474,46552,2838,510702,4611789,5122491,35795,53,5660,2266,58332,6993,421544,145,15146,6440,85
12/15/20,476224,11806,432510,10298,43714,1508,503591,4583105,5086696,65205,74,5607,4574,56066,7158,414551,158,15001,6355,66
12/14/20,464418,7922,422212,6854,42206,1068,491891,4529600,5021491,42297,79,5533,-2577,51492,10420,407393,111,14843,6289,76
12/13/20,456496,11224,415358,9843,41138,1381,484122,4495072,4979194,68967,62,5454,7745,54069,3417,396973,123,14732,6213,85
12/12/20,445272,8931,405515,7302,39757,1629,473051,4437176,4910227,47608,73,5392,5031,46324,3827,393556,135,14609,6128,80
12/11/20,436341,6033,398213,5100,38128,933,464756,4397863,4862619,32154,87,5319,1695,41293,4251,389729,115,14474,6048,68
12/10/20,430308,8882,393113,7758,37195,1124,459143,4371322,4830465,52296,69,5232,7552,39598,1261,385478,123,14359,5980,75
12/9/20,421426,5800,385355,5114,36071,686,450345,4327824,4778169,27601,62,5163,135,32046,5603,384217,100,14236,5905,62
12/8/20,415626,8079,380241,7003,35385,1076,444712,4305856,4750568,45057,100,5101,2309,31911,5670,378614,107,14136,5843,79
12/7/20,407547,7157,373238,6155,34309,1002,437002,4268509,4705511,35773,66,5001,-730,29602,7821,372944,87,14029,5764,72
12/6/20,400390,4061,367083,3420,33307,641,430330,4239408,4669738,19689,38,4935,1163,30332,2860,365123,46,13942,5692,86
12/5/20,396329,3072,363663,2522,32666,550,426588,4223461,4650049,15625,29,4897,12,29169,3031,362263,51,13896,5606,78
12/4/20,393257,5391,361141,4314,32116,1077,423910,4210514,4634424,26993,95,4868,-321,29157,5617,359232,94,13845,5528,83
12/3/20,387866,4820,356827,4009,31039,811,419066,4188365,4607431,25635,93,4773,584,29478,4143,353615,81,13751,5445,72
12/2/20,383046,2515,352818,2121,30228,394,414591,4167205,4581796,11853,50,4680,-2561,28894,5026,349472,61,13670,5373,67
12/1/20,380531,6702,350697,5705,29834,997,412434,4157509,4569943,36176,36,4630,1056,31455,5610,344446,110,13609,5306,68
11/30/20,373829,6008,344992,5432,28837,576,406289,4127478,4533767,40748,48,4594,-1172,30399,7132,338836,89,13499,5238,80
11/29/20,367821,5541,339560,5111,28261,430,400300,4092719,4493019,37931,13,4546,2513,31571,3015,331704,72,13410,5158,58
11/28/20,362280,4730,334449,4102,27831,628,394581,4060507,4455088,31919,15,4533,1639,29058,3076,328689,75,13338,5100,62
11/27/20,357550,5435,330347,4844,27203,591,389999,4033170,4423169,32635,7,4518,418,27419,5010,325613,81,13263,5038,80
11/26/20,352115,5296,325503,4934,26612,362,384446,4006088,4390534,52386,53,4511,-441,27001,5684,320603,60,13182,4958,47
11/25/20,346819,2183,320569,1582,26250,601,378562,3959586,4338148,12061,92,4458,-2384,27442,4475,314919,91,13122,4911,64
11/24/20,344636,2056,318987,1520,25649,536,377116,3948971,4326087,10733,73,4366,-3446,29826,5429,310444,91,13031,4847,66
11/23/20,342580,2213,317467,1852,25113,361,375610,3939744,4315354,11115,35,4293,-4676,33272,6854,305015,70,12940,4781,69
11/22/20,340367,5565,315615,5062,24752,503,373741,3930498,4304239,43855,55,4258,2914,37948,2596,298161,111,12870,4712,59
11/21/20,334802,3420,310553,2903,24249,517,368046,3892338,4260384,25932,9,4203,794,35034,2617,295565,81,12759,4653,74
11/20/20,331382,4048,307650,3534,23732,514,364884,3869568,4234452,24341,74,4194,-41,34240,4015,292948,66,12678,4579,67
11/19/20,327334,2999,304116,2283,23218,716,361050,3849061,4210111,16862,80,4120,-1360,34281,4279,288933,81,12612,4512,57
11/18/20,324335,4039,301833,3053,22502,986,358617,3834632,4193249,24017,53,4040,-99,35641,4085,284654,96,12531,4455,43
11/17/20,320296,3507,298780,3184,21516,323,355164,3814068,4169232,21238,72,3987,-127,35740,3562,280569,66,12435,4412,68
11/16/20,316789,4652,295596,4241,21193,411,351605,3796389,4147994,35160,30,3915,-79,35867,4701,277007,78,12369,4344,51
11/15/20,312137,6470,291355,5856,20782,614,346949,3765885,4112834,55521,16,3885,4523,35946,1931,272306,111,12291,4293,48
11/14/20,305667,4895,285499,4458,20168,437,340332,3716981,4057313,38281,25,3869,3067,31423,1803,270375,85,12180,4245,60
11/13/20,300772,4371,281041,3755,19731,616,335307,3683725,4019032,27162,64,3844,1533,28356,2774,268572,69,12095,4185,43
11/12/20,296401,3146,277286,2576,19115,570,331310,3660560,3991870,19295,27,3780,408,26823,2711,265798,55,12026,4142,36
11/11/20,293255,3928,274710,3304,18545,624,328567,3644008,3972575,28173,89,3753,990,26415,2849,263087,72,11971,4106,50
11/10/20,289327,3033,271406,2493,17921,540,324730,3619672,3944402,25722,62,3664,92,25425,2879,260238,83,11899,4056,50
11/9/20,286294,2384,268913,2053,17381,331,321965,3596715,3918680,19714,15,3602,-884,25333,3253,257359,43,11816,4006,42
11/8/20,283910,5407,266860,4866,17050,541,319663,3579303,3898966,55003,5,3587,3586,26217,1816,254106,89,11773,3964,40
11/7/20,278503,4188,261994,3856,16509,332,314126,3529837,3843963,43214,49,3582,2265,22631,1874,252290,87,11684,3924,33
11/6/20,274315,3602,258138,3027,16177,575,309614,3491135,3800749,28581,32,3533,953,20366,2617,250416,62,11597,3891,47
11/5/20,270713,1405,255111,1110,15602,295,306244,3465924,3772168,10920,31,3501,-1318,19413,2692,247799,52,11535,3844,40
11/4/20,269308,2648,254001,2347,15307,301,305027,3456221,3761248,23444,24,3470,-170,20731,2794,245107,68,11483,3804,50
11/3/20,266660,3018,251654,2714,15006,304,302416,3435388,3737804,24952,75,3446,235,20901,2708,242313,54,11415,3754,45
11/2/20,263642,1903,248940,1779,14702,124,299359,3413493,3712852,16689,26,3371,-1340,20666,3217,239605,64,11361,3709,38
11/1/20,261739,2483,247161,2118,14578,365,297407,3398756,3696163,34031,0,3345,776,22006,1707,236388,64,11297,3671,32
10/31/20,259256,149,245043,137,14213,12,294910,3367222,3662132,807,12,3345,-1542,21230,1679,234681,2,11233,3639,29
10/30/20,259107,2405,244906,2186,14201,219,294771,3366554,3661325,22321,78,3333,90,22772,2237,233002,62,11231,3610,40
10/29/20,256702,2374,242720,2040,13982,334,292437,3346567,3639004,25464,22,3255,29,22682,2323,230765,66,11169,3570,38
10/28/20,254328,2678,240680,2391,13648,287,290141,3323399,3613540,23105,34,3233,138,22653,2506,228442,67,11103,3532,38
10/27/20,251650,2446,238289,2039,13361,407,287508,3302927,3590435,22840,44,3199,-15,22515,2417,225936,101,11036,3494,46
10/26/20,249204,1507,236250,1319,12954,188,285218,3282377,3567595,11257,32,3155,-1380,22530,2855,223519,45,10935,3448,31
10/25/20,247697,3084,234931,2896,12766,188,283770,3272568,3556338,35747,31,3123,1585,23910,1468,220664,82,10890,3417,42
10/24/20,244613,3609,232035,3313,12578,296,280293,3240298,3520591,39871,24,3092,1918,22325,1667,219196,85,10808,3375,45
10/23/20,241004,2655,228722,2404,12282,251,276475,3204245,3480720,29991,65,3068,503,20407,2087,217529,73,10723,3330,33
10/22/20,238349,3183,226318,2831,12031,352,273805,3176924,3450729,35906,41,3003,1133,19904,2009,215442,90,10650,3297,28
10/21/20,235166,1734,223487,1487,11679,247,270599,3144224,3414823,15343,18,2962,-532,18771,2248,213433,44,10560,3269,38
10/20/20,233432,1967,222000,1682,11432,285,268885,3130595,3399480,18698,30,2944,-78,19303,2015,211185,60,10516,3231,37
10/19/20,231465,2190,220318,1996,11147,194,266860,3113922,3380782,20252,13,2914,-176,19381,2353,209170,91,10456,3194,33
10/18/20,229275,2637,218322,2463,10953,174,264820,3095710,3360530,39719,6,2901,1326,19557,1305,206817,73,10365,3161,21
10/17/20,226638,2684,215859,2478,10779,206,261909,3058902,3320811,36780,32,2895,1307,18231,1345,205512,75,10292,3140,27
10/16/20,223954,1719,213381,1526,10573,193,258921,3025110,3284031,16345,7,2863,-139,16924,1851,204167,44,10217,3113,29
10/15/20,222235,1425,211855,1220,10380,205,257350,3010336,3267686,16242,36,2856,-326,17063,1715,202316,52,10173,3084,41
10/14/20,220810,2312,210635,2109,10175,203,256007,2995437,3251444,22128,31,2820,566,17389,1715,200601,68,10121,3043,37
10/13/20,218498,1544,208526,1268,9972,276,253798,2975518,3229316,16118,23,2789,-19,16823,1540,198886,54,10053,3006,36
10/12/20,216954,1232,207258,1049,9696,183,252356,2960842,3213198,15372,7,2766,-826,16842,2051,197346,43,9999,2970,36
10/11/20,215722,2950,206209,2748,9513,202,251151,2946675,3197826,42917,9,2759,1855,17668,1086,195295,92,9956,2934,28
10/10/20,212772,1886,203461,1778,9311,108,247998,2906911,3154909,29448,26,2750,836,15813,1024,194209,51,9864,2906,29
10/9/20,210886,1418,201683,1246,9203,172,245972,2879489,3125461,26239,27,2724,54,14977,1337,193185,41,9813,2877,26
10/8/20,209468,2003,200437,1813,9031,190,244563,2854659,3099222,25615,63,2697,537,14923,1403,191848,67,9772,2851,26
10/7/20,207465,1842,198624,1575,8841,267,242626,2830981,3073607,23391,21,2634,351,14386,1470,190445,74,9705,2825,28
10/6/20,205623,1999,197049,1700,8574,299,240883,2809333,3050216,25398,24,2613,446,14035,1529,188975,91,9631,2797,27
10/5/20,203624,2215,195349,2001,8275,214,238919,2785899,3024818,35562,20,2589,368,13589,1827,187446,90,9540,2770,25
10/4/20,201409,1820,193348,1666,8061,154,236425,2752831,2989256,38322,17,2569,885,13221,918,185619,67,9450,2745,29
10/3/20,199589,1356,191682,1244,7907,112,234237,2716697,2950934,29117,45,2552,341,12336,970,184701,44,9383,2716,18
10/2/20,198233,1205,190438,1064,7795,141,232642,2689175,2921817,15624,14,2507,-298,11995,1489,183731,43,9339,2698,22
10/1/20,197028,1148,189374,1007,7654,141,231356,2674837,2906193,18503,47,2493,-310,12293,1411,182242,51,9296,2676,21
9/30/20,195880,1429,188367,1253,7513,176,230167,2657523,2887690,13516,34,2446,-86,12603,1481,180831,36,9245,2655,26
9/29/20,194451,1191,187114,975,7337,216,228700,2645474,2874174,20740,31,2412,-293,12689,1453,179350,63,9209,2629,14
9/28/20,193260,678,186139,547,7121,131,227401,2626033,2853434,8424,12,2381,-1226,12982,1892,177897,32,9146,2615,26
9/27/20,192582,1366,185592,1276,6990,90,226689,2618321,2845010,29515,3,2369,435,14208,928,176005,54,9114,2589,24
9/26/20,191216,2122,184316,1980,6900,142,225143,2590352,2815495,44207,22,2366,1032,13773,1068,175077,60,9060,2565,23
9/25/20,189094,1345,182336,1246,6758,99,222661,2548627,2771288,26155,42,2344,-118,12741,1421,174009,48,9000,2542,23
9/24/20,187749,1400,181090,1231,6659,169,221143,2523990,2745133,27195,35,2302,-103,12859,1468,172588,51,8952,2519,20
9/23/20,186349,916,179859,798,6490,118,219631,2498307,2717938,9433,14,2267,-628,12962,1530,171120,25,8901,2499,28
9/22/20,185433,1645,179061,1422,6372,223,218698,2489807,2708505,25548,28,2253,-183,13590,1800,169590,56,8876,2471,20
9/21/20,183788,668,177639,522,6149,146,216799,2466158,2682957,7093,15,2225,-394,13773,1047,167790,40,8820,2451,20
9/20/20,183120,1028,177117,914,6003,114,216090,2459774,2675864,20442,2,2210,138,14167,888,166743,38,8780,2431,26
9/19/20,182092,2137,176203,2036,5889,101,214887,2440535,2655422,48385,20,2208,1213,14029,904,165855,82,8742,2405,18
9/18/20,179955,1504,174167,1333,5788,171,212377,2394660,2607037,30073,32,2188,-312,12816,1784,164951,49,8660,2387,28
9/17/20,178451,1827,172834,1686,5617,141,210682,2366282,2576964,27797,13,2156,427,13128,1387,163167,54,8611,2359,26
9/16/20,176624,1063,171148,926,5476,137,208639,2340528,2549167,16766,24,2143,-377,12701,1416,161780,41,8557,2333,21
9/15/20,175561,1911,170222,1686,5339,225,207446,2324955,2532401,34215,30,2119,308,13078,1573,160364,68,8516,2312,17
9/14/20,173650,1600,168536,1435,5114,165,205163,2293023,2498186,22957,19,2089,-74,12770,1655,158791,78,8448,2295,27
9/13/20,172050,1400,167101,1315,4949,85,203377,2271852,2475229,22921,14,2070,389,12844,997,157136,44,8370,2268,14
9/12/20,170650,1334,165786,1257,4864,77,201685,2250623,2452308,26730,39,2056,466,12455,829,156139,42,8326,2254,35
9/11/20,169316,1008,164529,895,4787,113,200033,2225545,2425578,14962,37,2017,-1370,11989,2341,155310,40,8284,2219,28
9/10/20,168308,2002,163634,1823,4674,179,198917,2211699,2410616,31627,57,1980,514,13359,1431,152969,76,8244,2191,23
9/9/20,166306,1153,161811,1046,4495,107,196680,2182309,2378989,17734,35,1923,-337,12845,1455,151538,56,8168,2168,23
9/8/20,165153,818,160765,708,4388,110,195336,2165919,2361255,13086,27,1888,-754,13182,1545,150083,47,8112,2145,25
9/7/20,164335,783,160057,736,4278,47,194482,2153687,2348169,8063,4,1861,-962,13936,1741,148538,33,8065,2120,17
9/6/20,163552,828,159321,775,4231,53,193345,2146761,2340106,12306,3,1857,-62,14898,887,146797,38,8032,2103,35
9/5/20,162724,2561,158546,2491,4178,70,192432,2135368,2327800,35056,25,1854,1527,14960,1009,145910,48,7994,2068,21
9/4/20,160163,1118,156055,1038,4108,80,189508,2103236,2292744,13454,22,1829,-157,13433,1253,144901,46,7946,2047,21
9/3/20,159045,1658,155017,1515,4028,143,188321,2090969,2279290,28412,18,1807,20,13590,1620,143648,56,7900,2026,22
9/2/20,157387,1190,153502,1082,3885,108,186425,2064453,2250878,16467,16,1789,-328,13570,1502,142028,53,7844,2004,23
9/1/20,156197,1700,152420,1536,3777,164,185184,2049227,2234411,22888,27,1773,115,13898,1558,140526,66,7791,1981,22
8/31/20,154497,1247,150884,1177,3613,70,183203,2028320,2211523,12930,7,1746,-350,13783,1590,138968,39,7725,1959,24
8/30/20,153250,1462,149707,1428,3543,34,181789,2016804,2198593,8728,22,1739,526,14133,914,137378,34,7686,1935,16
8/29/20,151788,1534,148279,1425,3509,109,180184,2009681,2189865,25350,24,1717,366,13607,1144,136464,51,7652,1919,25
8/28/20,150254,1128,146854,1074,3400,54,178398,1986117,2164515,12665,28,1693,-483,13241,1583,135320,44,7601,1894,23
8/27/20,149126,2334,145780,2211,3346,123,177128,1974722,2151850,37149,25,1665,903,13724,1406,133737,67,7557,1871,25
8/26/20,146792,1325,143569,1209,3223,116,174409,1940292,2114701,18260,20,1640,-396,12821,1701,132331,56,7490,1846,30
8/25/20,145467,1713,142360,1595,3107,118,172869,1923572,2096441,30308,40,1620,114,13217,1559,130630,68,7434,1816,24
8/24/20,143754,645,140765,532,2989,113,170867,1895266,2066133,7169,21,1580,-1404,13103,2028,129071,41,7366,1792,35
8/23/20,143109,815,140233,751,2876,64,170160,1888804,2058964,14426,4,1559,-206,14507,1017,127043,42,7325,1757,24
8/22/20,142294,2437,139482,2374,2812,63,169245,1875293,2044538,52005,14,1555,1242,14713,1181,126026,71,7283,1733,17
8/21/20,139857,528,137108,485,2749,43,166314,1826219,1992533,10319,61,1541,-1227,13471,1694,124845,31,7212,1716,20
8/20/20,139329,2446,136623,2272,2706,174,165753,1816461,1982214,42964,36,1480,751,14698,1659,123151,84,7181,1696,20
8/19/20,136883,1346,134351,1280,2532,66,162946,1776304,1939250,20199,26,1444,-542,13947,1862,121492,55,7097,1676,22
8/18/20,135537,1784,133071,1664,2466,120,161386,1757665,1919051,37970,39,1418,-206,14489,1951,119630,65,7042,1654,16
8/17/20,133753,855,131407,718,2346,137,158906,1722175,1881081,9310,21,1379,-1301,14695,2135,117679,57,6977,1638,19
8/16/20,132898,1409,130689,1382,2209,27,158029,1713742,1871771,20005,21,1358,302,15996,1086,115544,42,6920,1619,30
8/15/20,131489,1944,129307,1858,2182,86,156228,1695538,1851766,27225,19,1337,601,15694,1324,114458,61,6878,1589,29
8/14/20,129545,1385,127449,1303,2096,82,153711,1670830,1824541,15144,13,1318,-342,15093,1714,113134,47,6817,1560,22
8/13/20,128160,2529,126146,2430,2014,99,152071,1657326,1809397,36798,24,1305,585,15435,1920,111420,123,6770,1538,24
8/12/20,125631,1256,123716,1215,1915,41,148719,1623880,1772599,13613,18,1281,-763,14850,2001,109500,60,6647,1514,24
8/11/20,124375,1811,122501,1697,1874,114,147339,1611647,1758986,24273,38,1263,-170,15613,1943,107499,78,6587,1490,26
8/10/20,122564,904,120804,852,1760,52,145163,1589550,1734713,8464,10,1225,-1482,15783,2376,105556,71,6509,1464,29
8/9/20,121660,1575,119952,1547,1708,28,144184,1582065,1726249,17488,8,1215,459,17265,1108,103180,50,6438,1435,14
8/8/20,120085,2112,118405,2049,1680,63,142280,1566481,1708761,33927,9,1207,943,16806,1160,102072,56,6388,1421,21
8/7/20,117973,1797,116356,1745,1617,52,139647,1535187,1674834,18546,20,1198,103,15863,1674,100912,102,6332,1400,25
8/6/20,116176,2743,114611,2630,1565,113,137488,1518800,1656288,32149,42,1178,990,15760,1711,99238,106,6230,1375,25
8/5/20,113433,1345,111981,1277,1452,68,134202,1489937,1624139,14151,27,1136,-663,14770,1981,97527,55,6124,1350,17
8/4/20,112088,1759,110704,1675,1384,84,132671,1477317,1609988,21037,25,1109,-387,15433,2121,95546,96,6069,1333,20
8/3/20,110329,1806,109029,1772,1300,34,130568,1458383,1588951,16893,19,1084,-707,15820,2494,93425,63,5973,1313,25
8/2/20,108523,1080,107257,1056,1266,24,128485,1443573,1572058,13155,6,1065,-74,16527,1148,90931,53,5910,1288,37
8/1/20,107443,2179,106201,2150,1242,29,127201,1431702,1558903,31942,7,1059,825,16601,1347,89783,67,5857,1251,23
7/31/20,105264,1754,104051,1705,1213,49,124408,1402553,1526961,18349,27,1052,-115,15776,1842,88436,68,5790,1228,27
7/30/20,103510,3592,102346,3549,1164,43,122454,1386158,1508612,43233,13,1025,1654,15891,1925,86594,138,5722,1201,29
7/29/20,99918,1185,98797,1156,1121,29,118073,1347306,1465379,9367,21,1012,-1251,14237,2415,84669,70,5584,1172,32
7/28/20,98733,2513,97641,2469,1092,44,116808,1339204,1456012,28742,21,991,128,15488,2364,82254,138,5514,1140,21
7/27/20,96220,1922,95172,1884,1048,38,113716,1313554,1427270,18049,11,970,-805,15360,2716,79890,107,5376,1119,17
7/26/20,94298,2329,93288,2276,1010,53,111456,1297765,1409221,26807,3,959,994,16165,1332,77174,80,5269,1102,21
7/25/20,91969,3101,91012,3061,957,40,108609,1273805,1382414,42415,26,956,1614,15171,1461,75842,117,5189,1081,20
7/24/20,88868,1864,87951,1818,917,46,104401,1235598,1339999,19347,13,930,-350,13557,2201,74381,99,5072,1061,28
7/23/20,87004,2547,86133,2498,871,49,102408,1218244,1320652,37688,37,917,399,13907,2111,72180,126,4973,1033,27
7/22/20,84457,2002,83635,1973,822,29,99186,1183778,1282964,17103,17,880,-466,13508,2451,70069,94,4847,1006,30
7/21/20,82455,3168,81662,3141,793,27,96887,1168974,1265861,39894,24,863,606,13974,2538,67618,155,4753,976,17
7/20/20,79287,1204,78521,1167,766,37,92969,1132998,1225967,9667,4,839,-1608,13368,2808,65080,54,4598,959,20
7/19/20,78083,1583,77354,1560,729,23,91652,1124648,1216300,18789,5,835,-18,14976,1596,62272,63,4544,939,16
7/18/20,76500,2133,75794,2111,706,22,89703,1107808,1197511,26479,23,830,827,14994,1283,60676,82,4481,923,17
7/17/20,74367,2131,73683,2086,684,45,87008,1084024,1171032,22069,19,807,515,14167,1597,59393,90,4399,906,16
7/16/20,72236,2975,71597,2932,639,43,84452,1064511,1148963,39879,13,788,1109,13652,1853,57796,117,4309,890,19
7/15/20,69261,1934,68665,1897,596,37,80576,1028508,1109084,19688,16,775,-123,12543,2041,55943,95,4192,871,17
7/14/20,67327,2122,66768,2080,559,42,78375,1011021,1089396,23621,18,759,212,12666,1892,53902,101,4097,854,11
7/13/20,65205,1831,64688,1800,517,31,75883,989892,1065775,17319,8,741,-100,12454,1923,52010,75,3996,843,19
7/12/20,63374,2324,62888,2299,486,25,73883,974573,1048456,28254,3,733,1220,12554,1101,50087,101,3921,824,17
7/11/20,61050,1179,60589,1165,461,14,71018,949184,1020202,15438,15,730,12,11334,1152,48986,51,3820,807,13
7/10/20,59871,1981,59424,1953,447,28,69466,935298,1004764,18336,13,715,565,11322,1403,47834,93,3769,794,17
7/9/20,57890,1807,57471,1780,419,27,67247,919181,986428,25176,25,702,377,10757,1405,46431,89,3676,777,17
7/8/20,56083,1654,55691,1629,392,25,65177,896075,961252,19196,20,677,58,10380,1576,45026,81,3587,760,12
7/7/20,54429,2154,54062,2144,367,10,63291,878765,942056,27244,12,657,720,10322,1422,43450,113,3506,748,18
7/6/20,52275,892,51918,878,357,14,60619,854193,914812,8255,7,645,-619,9602,1504,42028,61,3393,730,11
7/5/20,51383,1346,51040,1344,343,2,59699,846858,906557,15258,9,638,572,10221,765,40524,42,3332,719,18
7/4/20,50037,1461,49696,1459,341,2,58120,833179,891299,21499,4,629,625,9649,832,39759,57,3290,701,17
7/3/20,48576,1350,48237,1342,339,8,56256,813544,869800,16408,13,625,311,9024,1026,38927,55,3233,684,12
7/2/20,47226,1923,46895,1915,331,8,54762,798630,853392,26107,11,612,988,8713,924,37901,82,3178,672,9
7/1/20,45303,1429,44980,1424,323,5,52442,774843,827285,18371,5,601,465,7725,959,36977,61,3096,663,13
6/30/20,43874,1654,43556,1642,318,12,50736,758178,808914,25386,12,596,773,7260,869,36018,64,3035,650,12
6/29/20,42220,1786,41914,1779,306,7,48549,734979,783528,23016,0,584,795,6487,991,35149,89,2971,638,8
6/28/20,40434,655,40135,653,299,2,46533,713979,760512,10258,0,584,221,5692,434,34158,16,2882,630,8
6/27/20,39779,264,39482,258,297,6,45713,704541,750254,1850,7,584,-334,5471,591,33724,20,2866,622,8
6/26/20,39515,978,39224,954,291,24,45474,702930,748404,10322,10,577,289,5805,679,33133,59,2846,614,14
6/25/20,38537,1083,38270,1073,267,10,44456,693626,738082,14114,11,567,444,5516,628,32454,48,2787,600,9
6/24/20,37454,842,37197,834,257,8,43223,680745,723968,8465,14,556,122,5072,706,31826,48,2739,591,7
6/23/20,36612,1017,36363,1010,249,7,42241,673262,715503,11214,11,542,364,4950,642,31120,59,2691,584,5
6/22/20,35595,626,35353,614,242,12,41100,663189,704289,10540,5,531,-188,4586,809,30478,25,2632,579,6
6/21/20,34969,596,34739,595,230,1,40483,653266,693749,13747,2,526,202,4774,392,29669,21,2607,573,10
6/20/20,34373,409,34144,408,229,1,39638,640364,680002,9214,0,524,-61,4572,470,29277,24,2586,563,6
6/19/20,33964,745,33736,741,228,4,39089,631699,670788,10189,15,524,217,4633,513,28807,40,2562,557,9
6/18/20,33219,1098,32995,1096,224,2,38194,622405,660599,15631,12,509,499,4416,587,28294,71,2522,548,5
6/17/20,32121,409,31899,405,222,4,36940,608028,644968,5423,4,497,-221,3917,626,27707,22,2451,543,10
6/16/20,31712,614,31494,611,218,3,36521,603024,639545,7445,10,493,140,4138,464,27081,37,2429,533,6
6/15/20,31098,711,30883,698,215,13,35872,596228,632100,10493,8,483,18,3998,685,26617,37,2392,527,15
6/14/20,30387,607,30185,602,202,5,35066,586541,621607,13782,3,475,258,3980,346,25932,26,2355,512,9
6/13/20,29780,541,29583,536,197,5,34327,573498,607825,10693,4,472,159,3722,378,25586,21,2329,503,7
6/12/20,29239,546,29047,543,192,3,33595,563537,597132,9630,27,468,-43,3563,562,25208,31,2308,496,4
6/11/20,28693,615,28504,612,189,3,32973,554529,587502,9565,5,441,-159,3606,769,24646,26,2277,492,5
6/10/20,28078,427,27892,422,186,5,32274,545663,577937,8284,1,436,-181,3765,607,23877,40,2251,487,1
6/9/20,27651,585,27470,580,181,5,31902,537751,569653,9620,14,435,-49,3946,620,23270,38,2211,486,4
6/8/20,27066,489,26890,485,176,4,31228,528805,560033,9954,3,421,99,3995,387,22650,27,2173,482,5
6/7/20,26577,428,26405,426,172,2,30672,519407,550079,13954,1,418,157,3896,270,22263,22,2146,477,5
6/6/20,26149,471,25979,468,170,3,30048,506077,536125,10914,9,417,190,3739,272,21993,21,2124,472,10
6/5/20,25678,511,25511,502,167,9,29485,495726,525211,11827,7,408,8,3549,496,21721,20,2103,462,6
6/4/20,25167,227,25009,224,158,3,28873,484511,513384,5699,13,401,-266,3541,480,21225,19,2083,456,3
6/3/20,24940,357,24785,356,155,1,28658,479027,507685,7924,7,388,-156,3807,506,20745,33,2064,453,8
6/2/20,24583,651,24429,648,154,3,28241,471520,499761,14413,14,381,199,3963,438,20239,29,2031,445,7
6/1/20,23932,605,23781,601,151,4,27418,457930,485348,10439,3,367,-106,3764,708,19801,16,2002,438,6
5/31/20,23327,610,23180,608,147,2,26651,448258,474909,15606,0,364,395,3870,215,19093,44,1986,432,5
5/30/20,22717,461,22572,459,145,2,25946,433357,459303,9727,4,364,164,3475,293,18878,21,1942,427,10
5/29/20,22256,231,22113,228,143,3,25377,424199,449576,7118,4,360,-170,3311,397,18585,14,1921,417,7
5/28/20,22025,599,21885,598,140,1,25112,417346,442458,9274,3,356,221,3481,375,18188,31,1907,410,4
5/27/20,21426,216,21287,210,139,6,24440,408744,433184,6554,10,353,-126,3260,332,17813,26,1876,406,7
5/26/20,21210,356,21077,346,133,10,24248,402382,426630,7020,5,343,-34,3386,385,17481,20,1850,399,4
5/25/20,20854,601,20731,600,123,1,23847,395763,419610,11221,2,338,251,3420,348,17096,27,1830,395,6
5/24/20,20253,331,20131,331,122,0,23136,385253,408389,11949,7,336,120,3169,204,16748,17,1803,389,10
5/23/20,19922,421,19800,416,122,5,22719,373721,396440,11357,14,329,241,3049,166,16544,20,1786,379,6
5/22/20,19501,385,19384,381,117,4,22156,362927,385083,8791,2,315,84,2808,299,16378,28,1766,373,3
5/21/20,19116,385,19003,384,113,1,21732,354560,376292,6757,4,313,-255,2724,636,16079,15,1738,370,8
5/20/20,18731,259,18619,258,112,1,21343,348192,369535,8522,4,309,-314,2979,569,15443,17,1723,362,5
5/19/20,18472,335,18361,334,111,1,21027,339986,361013,6561,4,305,-98,3293,429,14874,25,1706,357,2
5/18/20,18137,343,18027,341,110,2,20638,333814,354452,8935,3,301,0,3391,340,14445,22,1681,355,4
5/17/20,17794,472,17686,472,108,0,20218,325299,345517,14078,3,298,305,3391,164,14105,21,1659,351,7
5/16/20,17322,261,17214,244,108,17,19625,311814,331439,11042,5,295,44,3086,212,13941,17,1638,344,6
5/15/20,17061,193,16970,191,91,2,19242,301155,320397,8270,3,290,-197,3042,387,13729,9,1621,338,8
5/14/20,16868,264,16779,263,89,1,19024,293103,312127,10224,14,287,-117,3239,367,13342,14,1612,330,15
5/13/20,16604,322,16516,319,88,3,18672,283231,301903,10041,9,273,-494,3356,807,12975,27,1598,315,11
5/12/20,16282,697,16197,697,85,0,18290,273572,291862,14887,13,264,-410,3850,1094,12168,22,1571,304,8
5/11/20,15585,555,15500,552,85,3,17474,259501,276975,9909,8,251,179,4260,368,11074,20,1549,296,4
5/10/20,15030,247,14948,244,82,3,16901,250165,267066,10156,1,243,64,4081,182,10706,10,1529,292,4
5/9/20,14783,246,14704,244,79,2,16541,240369,256910,9843,1,242,10,4017,235,10524,13,1519,288,8
5/8/20,14537,195,14460,194,77,1,16215,230852,247067,6611,4,241,-198,4007,389,10289,12,1506,280,6
5/7/20,14342,392,14266,390,76,2,15967,224489,240456,10765,-2,237,79,4205,315,9900,23,1494,274,8
5/6/20,13950,260,13876,260,74,0,15503,214188,229691,5908,13,239,-92,4126,339,9585,13,1471,266,3
5/5/20,13690,189,13616,188,74,1,15184,208599,223783,7847,7,226,-141,4218,323,9246,24,1458,263,10
5/4/20,13501,312,13428,308,73,4,14939,200997,215936,7108,9,219,-306,4359,609,8923,20,1434,253,6
5/3/20,13189,371,13120,365,69,6,14578,194250,208828,9464,1,210,119,4665,251,8314,25,1414,247,9
5/2/20,12818,238,12755,237,63,1,14140,185224,199364,7041,5,209,-99,4546,332,8063,18,1389,238,5
5/1/20,12580,769,12518,764,62,5,13787,178536,192323,9535,5,204,469,4645,295,7731,17,1371,233,5
4/30/20,11811,1002,11754,998,57,4,12976,169812,182788,5068,4,199,779,4176,219,7436,31,1354,228,5
4/29/20,10809,568,10756,566,53,2,11945,165775,177720,11035,7,195,331,3397,230,7217,30,1323,223,5
4/28/20,10241,274,10190,270,51,4,11278,155407,166685,6584,4,188,40,3066,230,6987,32,1293,218,6
4/27/20,9967,297,9920,293,47,4,10969,149132,160101,5450,3,184,-14,3026,308,6757,35,1261,212,5
4/26/20,9670,298,9627,297,43,1,10649,144002,154651,6615,3,181,139,3040,156,6449,17,1226,207,4
4/25/20,9372,302,9330,297,42,5,10302,137734,148036,4502,10,178,132,2901,160,6293,22,1209,203,6
4/24/20,9070,469,9033,460,37,9,9962,133572,143534,14346,-2,168,247,2769,224,6133,40,1187,197,5
4/23/20,8601,452,8573,450,28,2,9399,119789,129188,5112,4,170,300,2522,148,5909,17,1147,192,10
4/22/20,8149,499,8123,497,26,2,8915,115161,124076,8910,9,166,281,2222,209,5761,18,1130,182,3
4/21/20,7650,288,7626,286,24,2,8377,106789,115166,6858,5,157,96,1941,187,5552,24,1112,179,5
4/20/20,7362,251,7340,243,22,8,8045,100263,108308,6509,4,152,27,1845,220,5365,27,1088,174,4
4/19/20,7111,276,7097,276,14,0,7788,94011,101799,5191,3,148,151,1818,122,5145,10,1061,170,3
4/18/20,6835,173,6821,173,14,0,7464,89144,96608,5065,3,145,8,1667,162,5023,11,1051,167,2
4/17/20,6662,320,6648,319,14,1,7221,84322,91543,3257,1,142,125,1659,194,4861,30,1040,165,3
4/16/20,6342,291,6329,291,13,0,6858,81428,88286,4135,6,141,80,1534,205,4667,23,1010,162,6
4/15/20,6051,263,6038,263,13,0,6499,77652,84151,3108,11,135,19,1454,233,4462,18,987,156,6
4/14/20,5788,182,5775,182,13,0,6192,74851,81043,1755,15,124,-48,1435,215,4229,29,969,150,10
4/13/20,5606,217,5593,216,13,1,5967,73321,79288,4655,8,109,-9,1483,218,4014,38,940,140,8
4/12/20,5389,224,5377,222,12,2,5685,68948,74633,4964,0,101,82,1492,142,3796,32,902,132,8
4/11/20,5165,292,5155,292,10,0,5445,64224,69669,5134,3,101,26,1410,263,3654,42,870,124,7
4/10/20,4873,195,4863,194,10,1,5054,59481,64535,2384,4,98,-29,1384,220,3391,22,828,117,2
4/9/20,4678,280,4669,280,9,0,4866,57285,62151,3338,15,94,52,1413,213,3171,42,806,115,5
4/8/20,4398,205,4389,205,9,0,4567,54246,58813,2824,7,79,-46,1361,244,2958,30,764,110,16
4/7/20,4193,305,4184,305,9,0,4335,51654,55989,4984,7,72,59,1407,239,2714,43,734,94,7
4/6/20,3888,228,3879,228,9,0,3987,47018,51005,3679,21,65,-71,1348,278,2475,47,691,87,7
4/5/20,3660,312,3651,311,9,1,3740,43586,47326,3731,1,44,127,1419,184,2197,46,644,80,10
4/4/20,3348,201,3340,201,8,0,3388,40207,43595,3604,6,43,-14,1292,209,2013,26,598,70,4
4/3/20,3147,253,3139,252,8,1,3169,36822,39991,2502,5,37,3,1306,245,1804,42,572,66,16
4/2/20,2894,270,2887,270,7,0,2922,34567,37489,3991,8,32,37,1303,225,1559,58,530,50,6
4/1/20,2624,357,2617,357,7,0,2615,30883,33498,3642,1,24,134,1266,222,1334,58,472,44,8
3/31/20,2267,287,2260,287,7,0,2252,27604,29856,3025,10,23,70,1132,207,1112,46,414,36,8
3/30/20,1980,439,1973,439,7,0,1938,24893,26831,4949,6,13,226,1062,207,905,83,368,28,6
3/29/20,1541,102,1534,102,7,0,1493,20389,21882,822,1,7,-47,836,148,698,35,285,22,6
3/28/20,1439,196,1432,191,7,5,1401,19659,21060,2380,0,6,89,883,107,550,39,250,16,4
3/27/20,1243,207,1241,207,2,0,1200,17480,18680,2847,3,6,96,794,108,443,42,211,12,2
3/26/20,1036,167,1034,166,2,1,993,14840,15833,2946,0,3,84,698,83,335,30,169,10,4
3/25/20,869,157,868,157,1,0,815,12072,12887,2126,1,3,78,614,78,252,35,139,6,1
3/24/20,712,85,711,85,1,0,671,10090,10761,1127,0,2,30,536,55,174,21,104,5,1
3/23/20,627,122,626,122,1,0,599,9035,9634,1575,0,2,84,506,38,119,13,83,4,0
3/22/20,505,133,504,132,1,1,482,7577,8059,1488,1,2,108,422,24,81,27,70,4,1
3/21/20,372,151,372,151,0,0,392,6179,6571,2089,1,1,121,314,29,57,14,43,3,2
3/20/20,221,162,221,162,0,0,246,4236,4482,1081,0,0,142,193,20,28,14,29,1,1
3/19/20,59,30,59,30,0,0,179,3222,3401,835,0,0,22,51,8,8,9,15,0,0
3/18/20,29,11,29,11,0,0,118,2448,2566,591,0,0,11,29,0,0,3,6,0,0
3/17/20,18,4,18,4,0,0,84,1891,1975,1363,0,0,4,18,0,0,0,3,0,0
3/16/20,14,4,14,4,0,0,24,588,612,160,0,0,4,14,0,0,2,3,0,0
3/15/20,10,4,10,4,0,0,21,431,452,30,0,0,4,10,0,0,0,1,0,0
3/14/20,6,5,6,5,0,0,19,403,422,335,0,0,5,6,0,0,1,1,0,0
3/13/20,1,0,1,0,0,0,2,85,87,42,0,0,0,1,0,0,0,0,0,0
3/12/20,1,1,1,1,0,0,2,43,45,45,0,0,1,1,0,0,0,0,0,0